    F A S T X S
    Z S P O T H
    C X S U P O
    A X X C A U
    M Y C H L T
    A P P L E F